0105 0106 0204 0205 0206 0207 0303 0304 0305 0306 0307 0308 0402 0403 0404 0405 0406 0407 0408 0409 0501 0503 0504 0507 0508 0510 0603 0604 0607 0608 0703 0704 0705 0706 0707 0708 0803 0804 0805 0806 0807 0808 0903 0904 0905 0906 0907 0908
0202 0204 0207 0209 0302 0303 0304 0305 0306 0307 0308 0309 0403 0404 0405 0406 0407 0408 0504 0506 0507 0604 0605 0606 0607 0704 0705 0707 0804 0805 0806 0807 0904 0906 0907 1003 1004 1005 1003
0203 0204 0205 0206 0207 0208 0302 0309 0401 0402 0409 0410 0502 0503 0504 0505 0506 0507 0508 0509 0601 0604 0605 0606 0607 0610 0701 0702 0703 0704 0705 0706 0707 0708 0709 0710 0801 0803 0808 0810 0901 0902 0903 0904 0905 0906 0907 0908 0909 0910 1001 1002 1009 1010
0102 0103 0105 0107 0204 0207 0209 0210 0304 0306 0308 0402 0403 0404 0406 0410 0501 0503 0505 0506 0507 0508 0510 0603 0605 0606 0609 0702 0705 0706 0805 0806 0904 0905 0906 0907 0908 1003 1004 1005 1006 1007 1008 1009
0102 0103 0104 0107 0109 0203 0207 0209 0303 0307 0309 0403 0407 0408 0409 0602 0605 0607 0608 0609 0610 0702 0704 0707 0802 0803 0807 0808 0809 0902 0904 0907 1002 1005 1007 1008 1009 1010
0301 0303 0305 0306 039 0401 0403 0405 0407 049 0501 0503 0505 0507 059 0601 0602 0605 0606 069 0701 0703 0705 079 0801 0803 0805 089 901 903 905 99 
