0103 0201 0202 0203 0204 0205 0303 0403 0502 0503 0504
0101 0103 0105 0201 0202 0203 0204 0205 0302 0303 0304 0402 0404 0502 0503 0504
0102 0104 0201 0202 0203 0204 0205 0301 0302 0303 0304 0305 0402 0403 0404 0503
0103 0202 0203 0204 0301 0302 0303 0304 0305 0402 0404 0502 0503 0504
0102 0103 0104 0201 0202 0203 0204 0205 0301 0303 0305 0401 0402 0403 0404 0405 0502 0504
0101 0104 0202 0203 0302 0303 0403 0404 0405 0403 0405
0102 0103 0104 0201 0203 0205 0301 0302 0303 0305 0401 0405 0502 0503 0504
0101 0102 0103 0104 0105 0201 0205 0301 0302 0303 0304 0305 0401 0405 0501 0502 0503 0504 0505 
0101 0201 0202 0301 0302 0303 0401 0402 0403 0404 0501 0502 0503 0504 0505 
0103 0202 0203 0204 0301 0302 0303 0304 0305 0402 0403 0404 0502 0503 0504 
0102 0104 0201 0202 0203 0204 0205 0301 0302 0303 0304 0305 0401 0403 0405 0501 0505 
